11111111111111
11000000033011
11100000000111
11000000000011
11000020000011
11100111100111
11000000000011
11000000000011
11001111110011
11000000000011
11000000000011
11000000000011
11000000000011
11111111111111