11111111111111
11000000000011
11000000000011
11000300200011
11000111100011
11000000110011
11000300111111
11000111110011
11000000000011
11003000000011
11111110000111
11000000000111
11000000200011
11111111111111