11111111111111
11000000000011
11000000000011
11000030000011
11111030011111
11000020000011
11000000000011
11011100111011
11000000000011
11000000000011
11110000001111
11000000000011
11000000000011
11111111111111