11111111111111
11000000000011
11000000000011
11000011000011
11000000000011
11003000030011
11011100111011
11000000000011
11000000000011
11000000030011
11111000011111
11000000000011
11000000000011
11111111111111