11111111111111
11000000000011
11000000000011
11000300000011
11000111100011
11000000000011
11000000220011
11001111110011
11000000000011
11000000000011
11110000001111
11000000000011
11000000000011
11111111111111