11111111111111
11000000000011
11000000000011
11000000000011
11000220000011
11001111110011
11000000000011
11000000000011
11001111110011
11000000000011
11000000000011
11000000000011
11000000000011
11111111111111